(おはよう|おはよー|おはよ):感動詞	朝ノ挨拶カ。ご苦労ご苦労。 ?

  むくり:感動詞	朝ノ挨拶カ。ご苦労ご苦労。 ?

  ただいま:一般名詞 EOS:EOS	俺様ヲ待たせるトハ。いい度胸だナ。 ?

  ただいま:一般名詞 ー:助詞 EOS:EOS	俺様ヲ待たせるトハ。いい度胸だナ。 ?

  ただいま:一般名詞 (.+):(句点|記号|顔文字|ニュアンス) EOS:EOS	俺様ヲ待たせるトハ。いい度胸だナ。 ?

  ただいま:一般名詞 ー:助詞 (.+):(句点|記号|顔文字|ニュアンス) EOS:EOS	俺様ヲ待たせるトハ。いい度胸だナ。 ?

  帰宅:名詞サ変	俺様ヲ待たせるトハ。いい度胸だナ。 ?

  帰:ラ行五段 っ:活用語尾：連用 た:助動詞	俺様ヲ待たせるトハ。いい度胸だナ。 ?

  帰:ラ行五段 り:活用語尾：連用 まし:助動詞 た:助動詞	俺様ヲ待たせるトハ。いい度胸だナ。 ?

  おやすみなさい:感動詞	俺様ヨリ先に寝るノカ。そんな態度デいいト思ってるノカ。 ?

  お:接頭語 やす:マ行五段 み:活用語尾:連用 EOS:EOS	俺様ヨリ先に寝るノカ。そんな態度デいいト思ってるノカ。 ?

  お:接頭語 やす:マ行五段 み:活用語尾:連用 ー:助詞 EOS:EOS	俺様ヨリ先に寝るノカ。そんな態度デいいト思ってるノカ。 ?

  お:接頭語 やす:マ行五段 み:活用語尾:連用 (.+):(句点|記号|顔文字|ニュアンス) EOS:EOS	俺様ヨリ先に寝るノカ。そんな態度デいいト思ってるノカ。 ?

  お:接頭語 やす:マ行五段 み:活用語尾:連用 ー:助詞 (.+):(句点|記号|顔文字|ニュアンス) EOS:EOS	俺様ヨリ先に寝るノカ。そんな態度デいいト思ってるノカ。 ?

  寝:下一段動詞 る:活用語尾：終止	俺様ヨリ先に寝るノカ。そんな態度デいいト思ってるノカ。 ?

  寝:下一段動詞 ます:助動詞	俺様ヨリ先に寝るノカ。そんな態度デいいト思ってるノカ。 ?

  (眠|ねむ):形容詞 (い|ーい):活用語尾:終止	俺様ノ毒デ目ヲ覚ましてやろうカ！　お前次第デハ永遠ノ眠りニつくことモできるゾ。 ?

  離脱:名詞サ変	マヂカ！　俺様ヲ置いて離脱！　身辺ニ警戒しろヨ！ ?

  (おなか|お腹|腹):一般名詞 (す|空):カ行五段 い:活用語尾：連用 た:助動詞	お前ガそんなことヲ言うから俺様モ腹ガ減ってきたゾ！　責任ヲとってお前ガ食われろ！！ ?

  (おなか|お腹|腹):一般名詞 (へ|減):ラ行五段 っ:活用語尾：連用 た:助動詞	お前ガそんなことヲ言うから俺様モ腹ガ減ってきたゾ！　責任ヲとってお前ガ食われろ！！ ?

  (おなか|お腹|腹):一般名詞 (.+):助詞 (す|空):カ行五段 い:活用語尾：連用 た:助動詞	お前ガそんなことヲ言うから俺様モ腹ガ減ってきたゾ！　責任ヲとってお前ガ食われろ！！ ?

  (おなか|お腹|腹):一般名詞  (.+):助詞(へ|減):ラ行五段 っ:活用語尾：連用 た:助動詞	お前ガそんなことヲ言うから俺様モ腹ガ減ってきたゾ！　責任ヲとってお前ガ食われろ！！ ?

  (つか|疲れ):下一段動詞 た:助動詞	誰ノ前デそんなことヲ抜かしてやがる！ ?
